OOOOOOOOOO
OOOOOOOOOO
##########
#    X X #
#  O   # #
#E   C C #
######   #
OOOOO#####
OOOOOOOOOO
OOOOOOOOOO