##########
#        #
# CC #  C#
#  ####X #
#XC   X  #
# #  ## X#
# #####  #
###OOO## #
OOOOOO# E#
OOOOOO####