##########
######## #
#######  #
#######C #
#######  #
######X X#
###### CX#
#####  #C#
#####X CE#
##########