##########
#    X   #
#        #
###%%#####
#b    C  #
#  C ## ##
#    gggX#
#   ######
#E t#t m #
##########